###############
#S      #     #
##### # ### ###
#   # # #     #
# # # # ##### #
# # # #     # #
# # ####### # #
# #         # #
# ########### #
#             #
####### ##### #
E             #
###############